111111111111111111111111
11000000000C1000000000C1
100000000000100001111111
111000001001100000000001
10000000C001100000000001
10010000000P000001000001
1000010000010000100000C1
100000000000001001101011
1C10000001000000E00000C1
111111111111111111111111
