11111111111
1CC0000E0P1
11111111110
