11111111111111111111111111
10010000000C10000000000001
10000111110010000000000001
1P0011E0C00010000000000001
1P0011E0C00010000000000001
1P0011E0C00010000000000001
1P0011E0C00010000000000001
1P0011E0C00010000000000001
1P0011E0C00010000000000001
11111111111111111111111111
